11100000000000000111
11100000000000000111
11100000000000000111
11100000000000000111
11100000000000000111
11111111111111111111
00000010000000000000
00000000100000000000
00000000001000000000
00000000000010000000
00000000000000010000
00000000000000010000
00000000000000000000
00000000000000000000
00000000000000000000
