11100000000000000111
11100000000000000111
11100000000000000111
11100000000000000111
11100000000000000111
11111111111111111111
00000000000000000000
00000000001111000000
00000000001671000000
00000000001451000000
00000000001231000000
00000000001011100000
00000000001111100000
00000000000000000000
00000000000000000000
