11100000000000000111
11100000000000000111
11100000000000000111
11100000000000000111
11100000000000000111
11111111111111111111
00000000000000000000
00000100000000000000
00000000110000000000
00000000000000100000
00000000000000000000
00000000000110001111
00000000000000001111
00000000000000000001
00000000000000001111
