11111111111111111111111111111111111111111111111111111111111111111111111111111111
11111111111111111111111111111111111111111111111111111111111111111111111111111111
11111111111111111111111111111111111111111111111111111111111111111111111111111111
11111111111111111111111111111111111111111111111111111111111111111111111111111111
11111111111111111111111111111111111111111111111111111111111111111111111111111111
11111111111111111111111111111111111111111111111111111111111111111111111111111111
00000000000000000000000000000000000000000000000000000000000000000000000000000000
00000000000000000000000000000000000000000000000000000000000000000000000000000000
00000000000000000000000000000000000000000000000000000000000000000000000000000000
00000000000000000000000000000000000000000000000000000000000000000000000000000000
00000000000000000000000000000000000000000000000000000000000000000000000000000000
00000000000000000000000000000000000000000000000000000000000000000000000000000000
00000000000000000000000000000000000000000000000000000000000000000000000000000000
00000000000000000000000000000000000000000000000000000000000000000000000000000000
00000000000000000000000000000000000000000000000000000000000000000000000000000000
11111111111111111111111111111111111111111111111111111111111111111111111111111111
11111111111111111111111111111111111111111111111111111111111111111111111111111111
11111111111111111111111111111111111111111111111111111111111111111111111111111111
11111111111111111111111111111111111111111111111111111111111111111111111111111111
11111111111111111111111111111111111111111111111111111111111111111111111111111111
11111000000000011111111110000000000111111111100000000001111111111000000000011111
00000000000000000000000000000000000000000000000000000000000000000000000000000000
00000000066000000000000000000660000000000000000006600000000000000000066000000000
00000011111111000000000000111111110000000000001111111100000000000011111111000000
00000011111111000000000000111111110000000000001111111100000000000011111111000000
00000000000000000000000000000000000000000000000000000000000000000000000000000000
00000000000000000000000000000000000000000000000000000000000000000000000000000000
00000000000000000000000000000000000000000000000000000000000000000000000000000000
00000000000000000000000000000000000000000000000000000000000000000000000000000000
00000000000000000000000000000000000000000000000000000000000000000000000000000000
11111111111111111111111111111111111111111111111111111111111111111111111111111111
11111111111111111111111111111111111111111111111111111111111111111111111111111111
11111111111111111111111111111111111111111111111111111111111111111111111111111111
11111111111111111111111111111111111111111111111111111111111111111111111111111111
11111111111111111111111111111111111111111111111111111111111111111111111111111111
11110000000000001111111100000000000011111111000000000000111111110000000000001111
00000000000000000000000000000000000000000000000000000000000000000000000000000000
00000000066000000000000000000660000000000000000006600000000000000000066000000000
00000111111111100000000001111111111000000000011111111110000000000111111111100000
00000011111111000000000000111111110000000000001111111100000000000011111111000000
00000000000000000000000000000000000000000000000000000000000000000000000000000000
00000000000000000000000000000000000000000000000000000000000000000000000000000000
00000000000000000000000000000000000000000000000000000000000000000000000000000000
00000000000000000000000000000000000000000000000000000000000000000000000000000000
00000000000000000000000000000000000000000000000000000000000000000000000000000000
11111110000001111111111111100000011111111111111000000111111111111110000001111111
11111110011001111111111111100110011111111111111001100111111111111110011001111111
11111110000001111111111111100000011111111111111000000111111111111110000001111111
11111110000001111111111111100000011111111111111000000111111111111110000001111111
11111100000000111111111111000000001111111111110000000011111111111100000000111111
11110000000000001111111100000000000011111111000000000000111111110000000000001111
00000000000000000000000000000000000000000000000000000000000000000000000000000000
00000000000000000000000000000000000000000000000000000000000000000000000000000000
00000006666660000000000000066666600000000000000666666000000000000006666660000000
00000001111110000000000000011111100000000000000111111000000000000001111110000000
00000001111110000000000000011111100000000000000111111000000000000001111110000000
00000001111110000000000000011111100000000000000111111000000000000001111110000000
00000000000000000000000000000000000000000000000000000000000000000000000000000000
00000000000000000000000000000000000000000000000000000000000000000000000000000000
00000000000000000000000000000000000000000000000000000000000000000000000000000000
11111111111111111111111111111111111111111111111111111111111111111111111111111111
11111110000000001111111111100000000011111111111000000000111111111110000000001111
11111100000000000111111111000000000001111111110000000000011111111100000000000111
11111000111111100111111110001111111001111111100011111110011111111000111111100111
11110001111000000111111100011110000001111111000111100000011111110001111000000111
11100011111000000111111000111110000001111110001111100000011111100011111000000111
00000111111000000000000001111110000000000000011111100000000000000111111000000000
00000111111000000000000001111110000000000000011111100000000000000111111000000000
00000001111110000000000000011111100000000000000111111000000000000001111110000000
00000001111110011000000000011111100110000000000111111001100000000001111110011000
00000000011000011111000000000110000111110000000001100001111100000000011000011111
00000000011000000001000000000110000000010000000001100000000100000000011000000001
00000000000000000001000000000000000000010000000000000000000100000000000000000001
00000000000000000001000000000000000000010000000000000000000100000000000000000001
00000000000000000001000000000000000000010000000000000000000100000000000000000001
11111111111100001111111111111111000011111111111111110000111111111111111100001111
11100000000000001111111000000000000011111110000000000000111111100000000000001111
11100000000000000111111000000000000001111110000000000000011111100000000000000111
11100000011000000111111000000110000001111110000001100000011111100000011000000111
11100110011000000111111001100110000001111110011001100000011111100110011000000111
11100100011000000111111001000110000001111110010001100000011111100100011000000111
00000100111100000000000001001111000000000000010011110000000000000100111100000000
00000100000000000000000001000000000000000000010000000000000000000100000000000000
00000100000000000000000001000000000000000000010000000000000000000100000000000000
00000100000000000000000001000000000000000000010000000000000000000100000000000000
00000100000000000000000001000000000000000000010000000000000000000100000000000000
00000000000000000000000000000000000000000000000000000000000000000000000000000000
00000000000000000000000000000000000000000000000000000000000000000000000000000000
00000000000000000000000000000000000000000000000000000000000000000000000000000000
00000000000000000000000000000000000000000000000000000000000000000000000000000000
11111111111111111111111111111111111111111111111111111111111111111111111111111111
11100111111111111111111001111111111111111110011111111111111111100111111111111111
11100111111111111111111001111111111111111110011111111111111111100111111111111111
11100001111111111111111000011111111111111110000111111111111111100001111111111111
11100001111111111111111000011111111111111110000111111111111111100001111111111111
11100000011111111111111000000111111111111110000001111111111111100000011111111111
00001000011111111000000010000111111110000000100001111111100000001000011111111000
00001000000111111000000010000001111110000000100000011111100000001000000111111000
00001000000111111000000010000001111110000000100000011111100000001000000111111000
00001000000001111000000010000000011110000000100000000111100000001000000001111000
11111000000001111000111110000000011110001111100000000111100011111000000001111000
11111000000000011000111110000000000110001111100000000001100011111000000000011000
11111000000000011000111110000000000110001111100000000001100011111000000000011000
11111000000000000000111110000000000000001111100000000000000011111000000000000000
11111000000000000000111110000000000000001111100000000000000011111000000000000000
11111111111111111111111111111111111111111111111111111111111111111111111111111111
11111111111111111111111111111111111111111111111111111111111111111111111111111111
11111111111111111111111111111111111111111111111111111111111111111111111111111111
11111111111111111111111111111111111111111111111111111111111111111111111111111111
11111111111111111111111111111111111111111111111111111111111111111111111111111111
11111111111111111111111111111111111111111111111111111111111111111111111111111111
00000000000000000000000000000000000000000000000000000000000000000000000000000000
00000000000000000000000000000000000000000000000000000000000000000000000000000000
00000000000000000000000000000000000000000000000000000000000000000000000000000000
00000000000000000000000000000000000000000000000000000000000000000000000000000000
00000000000000000000000000000000000000000000000000000000000000000000000000000000
00000000000000000000000000000000000000000000000000000000000000000000000000000000
00000000000000000000000000000000000000000000000000000000000000000000000000000000
00000000000000000000000000000000000000000000000000000000000000000000000000000000
00000000000000000000000000000000000000000000000000000000000000000000000000000000
11111111111111111111111111111111111111111111111111111111111111111111111111111111
11111111111111111111111111111111111111111111111111111111111111111111111111111111
11111111111111111111111111111111111111111111111111111111111111111111111111111111
11111111111111111111111111111111111111111111111111111111111111111111111111111111
11111111111111111111111111111111111111111111111111111111111111111111111111111111
11111000000000011111111110000000000111111111100000000001111111111000000000011111
00000000000000000000000000000000000000000000000000000000000000000000000000000000
00000000066000000000000000000660000000000000000006600000000000000000066000000000
00000011111111000000000000111111110000000000001111111100000000000011111111000000
00000011111111000000000000111111110000000000001111111100000000000011111111000000
00000000000000000000000000000000000000000000000000000000000000000000000000000000
00000000000000000000000000000000000000000000000000000000000000000000000000000000
00000000000000000000000000000000000000000000000000000000000000000000000000000000
00000000000000000000000000000000000000000000000000000000000000000000000000000000
00000000000000000000000000000000000000000000000000000000000000000000000000000000
11111111111111111111111111111111111111111111111111111111111111111111111111111111
11111111111111111111111111111111111111111111111111111111111111111111111111111111
11111111111111111111111111111111111111111111111111111111111111111111111111111111
11111111111111111111111111111111111111111111111111111111111111111111111111111111
11111111111111111111111111111111111111111111111111111111111111111111111111111111
11110000000000001111111100000000000011111111000000000000111111110000000000001111
00000000000000000000000000000000000000000000000000000000000000000000000000000000
00000000066000000000000000000660000000000000000006600000000000000000066000000000
00000111111111100000000001111111111000000000011111111110000000000111111111100000
00000011111111000000000000111111110000000000001111111100000000000011111111000000
00000000000000000000000000000000000000000000000000000000000000000000000000000000
00000000000000000000000000000000000000000000000000000000000000000000000000000000
00000000000000000000000000000000000000000000000000000000000000000000000000000000
00000000000000000000000000000000000000000000000000000000000000000000000000000000
00000000000000000000000000000000000000000000000000000000000000000000000000000000
11111110000001111111111111100000011111111111111000000111111111111110000001111111
11111110011001111111111111100110011111111111111001100111111111111110011001111111
11111110000001111111111111100000011111111111111000000111111111111110000001111111
11111110000001111111111111100000011111111111111000000111111111111110000001111111
11111100000000111111111111000000001111111111110000000011111111111100000000111111
11110000000000001111111100000000000011111111000000000000111111110000000000001111
00000000000000000000000000000000000000000000000000000000000000000000000000000000
00000000000000000000000000000000000000000000000000000000000000000000000000000000
00000006666660000000000000066666600000000000000666666000000000000006666660000000
00000001111110000000000000011111100000000000000111111000000000000001111110000000
00000001111110000000000000011111100000000000000111111000000000000001111110000000
00000001111110000000000000011111100000000000000111111000000000000001111110000000
00000000000000000000000000000000000000000000000000000000000000000000000000000000
00000000000000000000000000000000000000000000000000000000000000000000000000000000
00000000000000000000000000000000000000000000000000000000000000000000000000000000
11111111111111111111111111111111111111111111111111111111111111111111111111111111
11111110000000001111111111100000000011111111111000000000111111111110000000001111
11111100000000000111111111000000000001111111110000000000011111111100000000000111
11111000111111100111111110001111111001111111100011111110011111111000111111100111
11110001111000000111111100011110000001111111000111100000011111110001111000000111
11100011111000000111111000111110000001111110001111100000011111100011111000000111
00000111111000000000000001111110000000000000011111100000000000000111111000000000
00000111111000000000000001111110000000000000011111100000000000000111111000000000
00000001111110000000000000011111100000000000000111111000000000000001111110000000
00000001111110011000000000011111100110000000000111111001100000000001111110011000
00000000011000011111000000000110000111110000000001100001111100000000011000011111
00000000011000000001000000000110000000010000000001100000000100000000011000000001
00000000000000000001000000000000000000010000000000000000000100000000000000000001
00000000000000000001000000000000000000010000000000000000000100000000000000000001
00000000000000000001000000000000000000010000000000000000000100000000000000000001
11111111111100001111111111111111000011111111111111110000111111111111111100001111
11100000000000001111111000000000000011111110000000000000111111100000000000001111
11100000000000000111111000000000000001111110000000000000011111100000000000000111
11100000011000000111111000000110000001111110000001100000011111100000011000000111
11100110011000000111111001100110000001111110011001100000011111100110011000000111
11100100011000000111111001000110000001111110010001100000011111100100011000000111
00000100111100000000000001001111000000000000010011110000000000000100111100000000
00000100000000000000000001000000000000000000010000000000000000000100000000000000
00000100000000000000000001000000000000000000010000000000000000000100000000000000
00000100000000000000000001000000000000000000010000000000000000000100000000000000
00000100000000000000000001000000000000000000010000000000000000000100000000000000
00000000000000000000000000000000000000000000000000000000000000000000000000000000
00000000000000000000000000000000000000000000000000000000000000000000000000000000
00000000000000000000000000000000000000000000000000000000000000000000000000000000
00000000000000000000000000000000000000000000000000000000000000000000000000000000
11111111111111111111111111111111111111111111111111111111111111111111111111111111
11100111111111111111111001111111111111111110011111111111111111100111111111111111
11100111111111111111111001111111111111111110011111111111111111100111111111111111
11100001111111111111111000011111111111111110000111111111111111100001111111111111
11100001111111111111111000011111111111111110000111111111111111100001111111111111
11100000011111111111111000000111111111111110000001111111111111100000011111111111
00001000011111111000000010000111111110000000100001111111100000001000011111111000
00001000000111111000000010000001111110000000100000011111100000001000000111111000
00001000000111111000000010000001111110000000100000011111100000001000000111111000
00001000000001111000000010000000011110000000100000000111100000001000000001111000
11111000000001111000111110000000011110001111100000000111100011111000000001111000
11111000000000011000111110000000000110001111100000000001100011111000000000011000
11111000000000011000111110000000000110001111100000000001100011111000000000011000
11111000000000000000111110000000000000001111100000000000000011111000000000000000
11111000000000000000111110000000000000001111100000000000000011111000000000000000
11111111111111111111111111111111111111111111111111111111111111111111111111111111
11111111111111111111111111111111111111111111111111111111111111111111111111111111
11111111111111111111111111111111111111111111111111111111111111111111111111111111
11111111111111111111111111111111111111111111111111111111111111111111111111111111
11111111111111111111111111111111111111111111111111111111111111111111111111111111
11111111111111111111111111111111111111111111111111111111111111111111111111111111
00000000000000000000000000000000000000000000000000000000000000000000000000000000
00000000000000000000000000000000000000000000000000000000000000000000000000000000
00000000000000000000000000000000000000000000000000000000000000000000000000000000
00000000000000000000000000000000000000000000000000000000000000000000000000000000
00000000000000000000000000000000000000000000000000000000000000000000000000000000
00000000000000000000000000000000000000000000000000000000000000000000000000000000
00000000000000000000000000000000000000000000000000000000000000000000000000000000
00000000000000000000000000000000000000000000000000000000000000000000000000000000
00000000000000000000000000000000000000000000000000000000000000000000000000000000
11111111111111111111111111111111111111111111111111111111111111111111111111111111
11111111111111111111111111111111111111111111111111111111111111111111111111111111
11111111111111111111111111111111111111111111111111111111111111111111111111111111
11111111111111111111111111111111111111111111111111111111111111111111111111111111
11111111111111111111111111111111111111111111111111111111111111111111111111111111
11111000000000011111111110000000000111111111100000000001111111111000000000011111
00000000000000000000000000000000000000000000000000000000000000000000000000000000
00000000066000000000000000000660000000000000000006600000000000000000066000000000
00000011111111000000000000111111110000000000001111111100000000000011111111000000
00000011111111000000000000111111110000000000001111111100000000000011111111000000
00000000000000000000000000000000000000000000000000000000000000000000000000000000
00000000000000000000000000000000000000000000000000000000000000000000000000000000
00000000000000000000000000000000000000000000000000000000000000000000000000000000
00000000000000000000000000000000000000000000000000000000000000000000000000000000
00000000000000000000000000000000000000000000000000000000000000000000000000000000

11111110000001111111111111100000011111111111111000000111111111111110000001111111
11111110011001111111111111100110011111111111111001100111111111111110011001111111
11111110000001111111111111100000011111111111111000000111111111111110000001111111
11111110000001111111111111100000011111111111111000000111111111111110000001111111
11111100000000111111111111000000001111111111110000000011111111111100000000111111
11110000000000001111111100000000000011111111000000000000111111110000000000001111
00000000000000000000000000000000000000000000000000000000000000000000000000000000
00000000000000000000000000000000000000000000000000000000000000000000000000000000
00000006666660000000000000066666600000000000000666666000000000000006666660000000
00000001111110000000000000011111100000000000000111111000000000000001111110000000
00000001111110000000000000011111100000000000000111111000000000000001111110000000
00000001111110000000000000011111100000000000000111111000000000000001111110000000
00000000000000000000000000000000000000000000000000000000000000000000000000000000
00000000000000000000000000000000000000000000000000000000000000000000000000000000
00000000000000000000000000000000000000000000000000000000000000000000000000000000
11111111111111111111111111111111111111111111111111111111111111111111111111111111
11111110000000001111111111100000000011111111111000000000111111111110000000001111
11111100000000000111111111000000000001111111110000000000011111111100000000000111
11111000111111100111111110001111111001111111100011111110011111111000111111100111
11110001111000000111111100011110000001111111000111100000011111110001111000000111
11100011111000000111111000111110000001111110001111100000011111100011111000000111
00000111111000000000000001111110000000000000011111100000000000000111111000000000
00000111111000000000000001111110000000000000011111100000000000000111111000000000
00000001111110000000000000011111100000000000000111111000000000000001111110000000
00000001111110011000000000011111100110000000000111111001100000000001111110011000
00000000011000011111000000000110000111110000000001100001111100000000011000011111
00000000011000000001000000000110000000010000000001100000000100000000011000000001
00000000000000000001000000000000000000010000000000000000000100000000000000000001
00000000000000000001000000000000000000010000000000000000000100000000000000000001
00000000000000000001000000000000000000010000000000000000000100000000000000000001
11111111111100001111111111111111000011111111111111110000111111111111111100001111
11100000000000001111111000000000000011111110000000000000111111100000000000001111
11100000000000000111111000000000000001111110000000000000011111100000000000000111
11100000011000000111111000000110000001111110000001100000011111100000011000000111
11100110011000000111111001100110000001111110011001100000011111100110011000000111
11100100011000000111111001000110000001111110010001100000011111100100011000000111
00000100111100000000000001001111000000000000010011110000000000000100111100000000
00000100000000000000000001000000000000000000010000000000000000000100000000000000
00000100000000000000000001000000000000000000010000000000000000000100000000000000
00000100000000000000000001000000000000000000010000000000000000000100000000000000
00000100000000000000000001000000000000000000010000000000000000000100000000000000
00000000000000000000000000000000000000000000000000000000000000000000000000000000
00000000000000000000000000000000000000000000000000000000000000000000000000000000
00000000000000000000000000000000000000000000000000000000000000000000000000000000
00000000000000000000000000000000000000000000000000000000000000000000000000000000
11111111111111111111111111111111111111111111111111111111111111111111111111111111
11100111111111111111111001111111111111111110011111111111111111100111111111111111
11100111111111111111111001111111111111111110011111111111111111100111111111111111
11100001111111111111111000011111111111111110000111111111111111100001111111111111
11100001111111111111111000011111111111111110000111111111111111100001111111111111
11100000011111111111111000000111111111111110000001111111111111100000011111111111
00001000011111111000000010000111111110000000100001111111100000001000011111111000
00001000000111111000000010000001111110000000100000011111100000001000000111111000
00001000000111111000000010000001111110000000100000011111100000001000000111111000
00001000000001111000000010000000011110000000100000000111100000001000000001111000
11111000000001111000111110000000011110001111100000000111100011111000000001111000
11111000000000011000111110000000000110001111100000000001100011111000000000011000
11111000000000011000111110000000000110001111100000000001100011111000000000011000
11111000000000000000111110000000000000001111100000000000000011111000000000000000
11111000000000000000111110000000000000001111100000000000000011111000000000000000