11100000000000000111
11100000000000000111
11100000000000000111
11100000000000000111
11100000000000011111
11111111111111111111
00000000100020000000
00000000100000000000
00000000000000000000
00000000000000000000
00000000000000000000
00000000000000000000
00000000000000000000
00000000000000000000
00000000000000000000
