11100011111110000111
11100001111110000111
11100000111110000111
11100000011110000111
11111111111111111111
11111111111111111111
00000011111100110000
00000000011100110000
00000000000000110000
00000000000000000000
00000000000000000000
00000000000000000000
00000000000000000000
00000000000000000000
00000000000000000000
