11100111111000000111
11100000000000000111
11100000000000000111
11100000000000000111
11111111111111111111
11111111111111111111
00000111100000000000
00000011101111000000
00000000101671000000
00000000001451000000
00000000001231000000
00000000001011100000
00000000001111100000
00000000000000000000
00000000000000000000
