11100011111110000111
11100001111110000111
11100000111110000111
11100000011110000111
11111111111111111111
11111111111111111111
00000000004400000000
00000000000000000000
00000000000000000000
00000000000000000000
01111000000000000000
00000111100000000000
00000000000000000000
00000000000000000000
00000000000000000000
11100011111110000111
11100001111110000111
11100000111110000111
11100000011110000111
11111111111111111111
11111111111111111111
00000000004400000000
00000000000000000000
00000000000000000000
00000000000000000000
01111000000000000000
00000111111000000000
00000000000000000000
00000000000000000000
00000000000000000000
11100011111110000111
11100001111110000111
11100000111110000111
11100000011110000111
11111111111111111111
11111111111111111111
00000000004400000000
00000000000000000000
00000000000000000000
00000000000000000000
01111000000000000000
00000111111000000000
00000000000111000000
00000000000000000000
00000000000000000000
11100011111110000111
11100001111110000111
11100000111110000111
11100000011110000111
11111111111111111111
11111111111111111111
00000000004400000000
00000000000000000000
00000000000000000000
00000000000000000000
01111000000000000000
00000111111000000000
00000000000111000000
00000000000000111000
00000000000000000000
