11111111111111111111111111111111111111111111111111111111111111111111111111111111
11111111111111111111111111111111111111111111111111111111111111111111111111111111
11111111111111111111111111111111111111111111111111111111111111111111111111111111
11111111111111111111111111111111111111111111111111111111111111111111111111111111
11111100000000111111111111000000001111111111110000000011111111111100000000111111
11111100000000111111111111000000001111111111110000000011111111111100000000111111
00000000000000000000000000000000000000000000000000000000000000000000000000000000
00000000000000000000000000000000000000000000000000000000000000000000000000000000
00000000000000000000000000000000000000000000000000000000000000000000000000000000
00000000000000000000000000000000000000000000000000000000000000000000000000000000
00000000000000000000000000000000000000000000000000000000000000000000000000000000
00000000000000000000000000000000000000000000000000000000000000000000000000000000
00000000000000000000000000000000000000000000000000000000000000000000000000000000
00000000000000000000000000000000000000000000000000000000000000000000000000000000
00000000000000000000000000000000000000000000000000000000000000000000000000000000
11111111111111111111111111111111111111111111111111111111111111111111111111111111
11111111111111111111111111111111111111111111111111111111111111111111111111111111
11111111111111111111111111111111111111111111111111111111111111111111111111111111
11111111111111111111111111111111111111111111111111111111111111111111111111111111
11111100111100111111111111001111001111111111110011110011111111111100111100111111
11111100111100111111111111001111001111111111110011110011111111111100111100111111
00000000000000000000000000000000000000000000000000000000000000000000000000000000
00000000000000000000000000000000000000000000000000000000000000000000000000000000
00000000000000000000000000000000000000000000000000000000000000000000000000000000
00000000000000000000000000000000000000000000000000000000000000000000000000000000
66666666666666666666666666666666666666666666666666666666666666666666666666666666
11111111111111111111111111111111111111111111111111111111111111111111111111111111
11111111111111111111111111111111111111111111111111111111111111111111111111111111
11111111111111111111111111111111111111111111111111111111111111111111111111111111
11111111111111111111111111111111111111111111111111111111111111111111111111111111
11111111111111111111111111111111111111111111111111111111111111111111111111111111
11111111111111111111111111111111111111111111111111111111111111111111111111111111
11111111111111111111111111111111111111111111111111111111111111111111111111111111
11111111111111111111111111111111111111111111111111111111111111111111111111111111
11111111111111111111111111111111111111111111111111111111111111111111111111111111
11110000000000001111111100000000000011111111000000000000111111110000000000001111
00000000000000000000000000000000000000000000000000000000000000000000000000000000
00000000066000000000000000000660000000000000000006600000000000000000066000000000
00000111111111100000000001111111111000000000011111111110000000000111111111100000
00000011111111000000000000111111110000000000001111111100000000000011111111000000
00000000000000000000000000000000000000000000000000000000000000000000000000000000
00000000000000000000000000000000000000000000000000000000000000000000000000000000
00000000000000000000000000000000000000000000000000000000000000000000000000000000
00000000000000000000000000000000000000000000000000000000000000000000000000000000
00000000000000000000000000000000000000000000000000000000000000000000000000000000
11111111011011111111111111110110111111111111111101101111111111111111011011111111
11111111011011111111111111110110111111111111111101101111111111111111011011111111
11111111000011111111111111110000111111111111111100001111111111111111000011111111
11111111000011111111111111110000111111111111111100001111111111111111000011111111
11111100000000111111111111000000001111111111110000000011111111111100000000111111
11111100000000111111111111000000001111111111110000000011111111111100000000111111
00000000000000000000000000000000000000000000000000000000000000000000000000000000
00000000000000000000000000000000000000000000000000000000000000000000000000000000
00000000666600000000000000006666000000000000000066660000000000000000666600000000
00000000111100000000000000001111000000000000000011110000000000000000111100000000
00000000111100000000000000001111000000000000000011110000000000000000111100000000
00000000000000000000000000000000000000000000000000000000000000000000000000000000
00000000000000000000000000000000000000000000000000000000000000000000000000000000
00000000000000000000000000000000000000000000000000000000000000000000000000000000
00000000000000000000000000000000000000000000000000000000000000000000000000000000
11111111111111111111111111111111111111111111111111111111111111111111111111111111
11111111111111111111111111111111111111111111111111111111111111111111111111111111
11111111000011111111111111110000111111111111111100001111111111111111000011111111
11111110000001111111111111100000011111111111111000000111111111111110000001111111
11111110000001111111111111100000011111111111111000000111111111111110000001111111
11111100011000111111111111000110001111111111110001100011111111111100011000111111
00010000711500001000000100007115000010000001000071150000100000010000711500001000
00000000711500000000000000007115000000000000000071150000000000000000711500000000
00000000044000000000000000000440000000000000000004400000000000000000044000000000
00000000000000000000000000000000000000000000000000000000000000000000000000000000
00000000000000000000000000000000000000000000000000000000000000000000000000000000
00000000000000000000000000000000000000000000000000000000000000000000000000000000
00000000000000000000000000000000000000000000000000000000000000000000000000000000
00000000000000000000000000000000000000000000000000000000000000000000000000000000
00000000000000000000000000000000000000000000000000000000000000000000000000000000
11111111111111111111111111111111111111111111111111111111111111111111111111111111
11111111111111111111111111111111111111111111111111111111111111111111111111111111
11111111111111111111111111111111111111111111111111111111111111111111111111111111
11111111111111111111111111111111111111111111111111111111111111111111111111111111
11111100000000111111111111000000001111111111110000000011111111111100000000111111
11111100000000111111111111000000001111111111110000000011111111111100000000111111
00000000000000000000000000000000000000000000000000000000000000000000000000000000
00000000000000000000000000000000000000000000000000000000000000000000000000000000
00000000000000000000000000000000000000000000000000000000000000000000000000000000
00000000000000000000000000000000000000000000000000000000000000000000000000000000
00000000000000000000000000000000000000000000000000000000000000000000000000000000
00000000000000000000000000000000000000000000000000000000000000000000000000000000
00000000000000000000000000000000000000000000000000000000000000000000000000000000
00000000000000000000000000000000000000000000000000000000000000000000000000000000
00000000000000000000000000000000000000000000000000000000000000000000000000000000
11111111111111111111111111111111111111111111111111111111111111111111111111111111
11111111111111111111111111111111111111111111111111111111111111111111111111111111
11111111111111111111111111111111111111111111111111111111111111111111111111111111
11111111111111111111111111111111111111111111111111111111111111111111111111111111
11111100111100111111111111001111001111111111110011110011111111111100111100111111
11111100111100111111111111001111001111111111110011110011111111111100111100111111
00000000000000000000000000000000000000000000000000000000000000000000000000000000
00000000000000000000000000000000000000000000000000000000000000000000000000000000
00000000000000000000000000000000000000000000000000000000000000000000000000000000
00000000000000000000000000000000000000000000000000000000000000000000000000000000
66666666666666666666666666666666666666666666666666666666666666666666666666666666
11111111111111111111111111111111111111111111111111111111111111111111111111111111
11111111111111111111111111111111111111111111111111111111111111111111111111111111
11111111111111111111111111111111111111111111111111111111111111111111111111111111
11111111111111111111111111111111111111111111111111111111111111111111111111111111
11111111111111111111111111111111111111111111111111111111111111111111111111111111
11111111111111111111111111111111111111111111111111111111111111111111111111111111
11111111111111111111111111111111111111111111111111111111111111111111111111111111
11111111111111111111111111111111111111111111111111111111111111111111111111111111
11111111111111111111111111111111111111111111111111111111111111111111111111111111
11110000000000001111111100000000000011111111000000000000111111110000000000001111
00000000000000000000000000000000000000000000000000000000000000000000000000000000
00000000066000000000000000000660000000000000000006600000000000000000066000000000
00000111111111100000000001111111111000000000011111111110000000000111111111100000
00000011111111000000000000111111110000000000001111111100000000000011111111000000
00000000000000000000000000000000000000000000000000000000000000000000000000000000
00000000000000000000000000000000000000000000000000000000000000000000000000000000
00000000000000000000000000000000000000000000000000000000000000000000000000000000
00000000000000000000000000000000000000000000000000000000000000000000000000000000
00000000000000000000000000000000000000000000000000000000000000000000000000000000
11111111011011111111111111110110111111111111111101101111111111111111011011111111
11111111011011111111111111110110111111111111111101101111111111111111011011111111
11111111000011111111111111110000111111111111111100001111111111111111000011111111
11111111000011111111111111110000111111111111111100001111111111111111000011111111
11111100000000111111111111000000001111111111110000000011111111111100000000111111
11111100000000111111111111000000001111111111110000000011111111111100000000111111
00000000000000000000000000000000000000000000000000000000000000000000000000000000
00000000000000000000000000000000000000000000000000000000000000000000000000000000
00000000666600000000000000006666000000000000000066660000000000000000666600000000
00000000111100000000000000001111000000000000000011110000000000000000111100000000
00000000111100000000000000001111000000000000000011110000000000000000111100000000
00000000000000000000000000000000000000000000000000000000000000000000000000000000
00000000000000000000000000000000000000000000000000000000000000000000000000000000
00000000000000000000000000000000000000000000000000000000000000000000000000000000
00000000000000000000000000000000000000000000000000000000000000000000000000000000
11111111111111111111111111111111111111111111111111111111111111111111111111111111
11111111111111111111111111111111111111111111111111111111111111111111111111111111
11111111000011111111111111110000111111111111111100001111111111111111000011111111
11111110000001111111111111100000011111111111111000000111111111111110000001111111
11111110000001111111111111100000011111111111111000000111111111111110000001111111
11111100011000111111111111000110001111111111110001100011111111111100011000111111
00010000711500001000000100007115000010000001000071150000100000010000711500001000
00000000711500000000000000007115000000000000000071150000000000000000711500000000
00000000044000000000000000000440000000000000000004400000000000000000044000000000
00000000000000000000000000000000000000000000000000000000000000000000000000000000
00000000000000000000000000000000000000000000000000000000000000000000000000000000
00000000000000000000000000000000000000000000000000000000000000000000000000000000
00000000000000000000000000000000000000000000000000000000000000000000000000000000
00000000000000000000000000000000000000000000000000000000000000000000000000000000
00000000000000000000000000000000000000000000000000000000000000000000000000000000
11111111111111111111111111111111111111111111111111111111111111111111111111111111
11111111111111111111111111111111111111111111111111111111111111111111111111111111
11111111111111111111111111111111111111111111111111111111111111111111111111111111
11111111111111111111111111111111111111111111111111111111111111111111111111111111
11111100000000111111111111000000001111111111110000000011111111111100000000111111
11111100000000111111111111000000001111111111110000000011111111111100000000111111
00000000000000000000000000000000000000000000000000000000000000000000000000000000
00000000000000000000000000000000000000000000000000000000000000000000000000000000
00000000000000000000000000000000000000000000000000000000000000000000000000000000
00000000000000000000000000000000000000000000000000000000000000000000000000000000
00000000000000000000000000000000000000000000000000000000000000000000000000000000
00000000000000000000000000000000000000000000000000000000000000000000000000000000
00000000000000000000000000000000000000000000000000000000000000000000000000000000
00000000000000000000000000000000000000000000000000000000000000000000000000000000
00000000000000000000000000000000000000000000000000000000000000000000000000000000
11111111111111111111111111111111111111111111111111111111111111111111111111111111
11111111111111111111111111111111111111111111111111111111111111111111111111111111
11111111111111111111111111111111111111111111111111111111111111111111111111111111
11111111111111111111111111111111111111111111111111111111111111111111111111111111
11111100111100111111111111001111001111111111110011110011111111111100111100111111
11111100111100111111111111001111001111111111110011110011111111111100111100111111
00000000000000000000000000000000000000000000000000000000000000000000000000000000
00000000000000000000000000000000000000000000000000000000000000000000000000000000
00000000000000000000000000000000000000000000000000000000000000000000000000000000
00000000000000000000000000000000000000000000000000000000000000000000000000000000
66666666666666666666666666666666666666666666666666666666666666666666666666666666
11111111111111111111111111111111111111111111111111111111111111111111111111111111
11111111111111111111111111111111111111111111111111111111111111111111111111111111
11111111111111111111111111111111111111111111111111111111111111111111111111111111
11111111111111111111111111111111111111111111111111111111111111111111111111111111
11111111111111111111111111111111111111111111111111111111111111111111111111111111
11111111111111111111111111111111111111111111111111111111111111111111111111111111
11111111111111111111111111111111111111111111111111111111111111111111111111111111
11111111111111111111111111111111111111111111111111111111111111111111111111111111
11111111111111111111111111111111111111111111111111111111111111111111111111111111
11110000000000001111111100000000000011111111000000000000111111110000000000001111
00000000000000000000000000000000000000000000000000000000000000000000000000000000
00000000066000000000000000000660000000000000000006600000000000000000066000000000
00000111111111100000000001111111111000000000011111111110000000000111111111100000
00000011111111000000000000111111110000000000001111111100000000000011111111000000
00000000000000000000000000000000000000000000000000000000000000000000000000000000
00000000000000000000000000000000000000000000000000000000000000000000000000000000
00000000000000000000000000000000000000000000000000000000000000000000000000000000
00000000000000000000000000000000000000000000000000000000000000000000000000000000
00000000000000000000000000000000000000000000000000000000000000000000000000000000
11111111011011111111111111110110111111111111111101101111111111111111011011111111
11111111011011111111111111110110111111111111111101101111111111111111011011111111
11111111000011111111111111110000111111111111111100001111111111111111000011111111
11111111000011111111111111110000111111111111111100001111111111111111000011111111
11111100000000111111111111000000001111111111110000000011111111111100000000111111
11111100000000111111111111000000001111111111110000000011111111111100000000111111
00000000000000000000000000000000000000000000000000000000000000000000000000000000
00000000000000000000000000000000000000000000000000000000000000000000000000000000
00000000666600000000000000006666000000000000000066660000000000000000666600000000
00000000111100000000000000001111000000000000000011110000000000000000111100000000
00000000111100000000000000001111000000000000000011110000000000000000111100000000
00000000000000000000000000000000000000000000000000000000000000000000000000000000
00000000000000000000000000000000000000000000000000000000000000000000000000000000
00000000000000000000000000000000000000000000000000000000000000000000000000000000
00000000000000000000000000000000000000000000000000000000000000000000000000000000
11111111111111111111111111111111111111111111111111111111111111111111111111111111
11111111111111111111111111111111111111111111111111111111111111111111111111111111
11111111000011111111111111110000111111111111111100001111111111111111000011111111
11111110000001111111111111100000011111111111111000000111111111111110000001111111
11111110000001111111111111100000011111111111111000000111111111111110000001111111
11111100011000111111111111000110001111111111110001100011111111111100011000111111
00010000711500001000000100007115000010000001000071150000100000010000711500001000
00000000711500000000000000007115000000000000000071150000000000000000711500000000
00000000044000000000000000000440000000000000000004400000000000000000044000000000
00000000000000000000000000000000000000000000000000000000000000000000000000000000
00000000000000000000000000000000000000000000000000000000000000000000000000000000
00000000000000000000000000000000000000000000000000000000000000000000000000000000
00000000000000000000000000000000000000000000000000000000000000000000000000000000
00000000000000000000000000000000000000000000000000000000000000000000000000000000
11111111111111111111111111111111111111111111111111111111111111111111111111111111
11111111111111111111111111111111111111111111111111111111111111111111111111111111
11111111111111111111111111111111111111111111111111111111111111111111111111111111
11111111111111111111111111111111111111111111111111111111111111111111111111111111
11111100000000111111111111000000001111111111110000000011111111111100000000111111
11111100000000111111111111000000001111111111110000000011111111111100000000111111
00000000000000000000000000000000000000000000000000000000000000000000000000000000
00000000000000000000000000000000000000000000000000000000000000000000000000000000
00000000000000000000000000000000000000000000000000000000000000000000000000000000
00000000000000000000000000000000000000000000000000000000000000000000000000000000
00000000000000000000000000000000000000000000000000000000000000000000000000000000
00000000000000000000000000000000000000000000000000000000000000000000000000000000
00000000000000000000000000000000000000000000000000000000000000000000000000000000
00000000000000000000000000000000000000000000000000000000000000000000000000000000
00000000000000000000000000000000000000000000000000000000000000000000000000000000
11111111111111111111111111111111111111111111111111111111111111111111111111111111
11111111111111111111111111111111111111111111111111111111111111111111111111111111
11111111111111111111111111111111111111111111111111111111111111111111111111111111
11111111111111111111111111111111111111111111111111111111111111111111111111111111
11111100111100111111111111001111001111111111110011110011111111111100111100111111
11111100111100111111111111001111001111111111110011110011111111111100111100111111
00000000000000000000000000000000000000000000000000000000000000000000000000000000
00000000000000000000000000000000000000000000000000000000000000000000000000000000
00000000000000000000000000000000000000000000000000000000000000000000000000000000
00000000000000000000000000000000000000000000000000000000000000000000000000000000
66666666666666666666666666666666666666666666666666666666666666666666666666666666
11111111111111111111111111111111111111111111111111111111111111111111111111111111
11111111111111111111111111111111111111111111111111111111111111111111111111111111
11111111111111111111111111111111111111111111111111111111111111111111111111111111
11111111111111111111111111111111111111111111111111111111111111111111111111111111
11111111111111111111111111111111111111111111111111111111111111111111111111111111
11111111111111111111111111111111111111111111111111111111111111111111111111111111
11111111111111111111111111111111111111111111111111111111111111111111111111111111
11111111111111111111111111111111111111111111111111111111111111111111111111111111
11111111111111111111111111111111111111111111111111111111111111111111111111111111
11110000000000001111111100000000000011111111000000000000111111110000000000001111
00000000000000000000000000000000000000000000000000000000000000000000000000000000
00000000066000000000000000000660000000000000000006600000000000000000066000000000
00000111111111100000000001111111111000000000011111111110000000000111111111100000
00000011111111000000000000111111110000000000001111111100000000000011111111000000
00000000000000000000000000000000000000000000000000000000000000000000000000000000
00000000000000000000000000000000000000000000000000000000000000000000000000000000
00000000000000000000000000000000000000000000000000000000000000000000000000000000
00000000000000000000000000000000000000000000000000000000000000000000000000000000
00000000000000000000000000000000000000000000000000000000000000000000000000000000
11111111011011111111111111110110111111111111111101101111111111111111011011111111
11111111011011111111111111110110111111111111111101101111111111111111011011111111
11111111000011111111111111110000111111111111111100001111111111111111000011111111
11111111000011111111111111110000111111111111111100001111111111111111000011111111
11111100000000111111111111000000001111111111110000000011111111111100000000111111
11111100000000111111111111000000001111111111110000000011111111111100000000111111
00000000000000000000000000000000000000000000000000000000000000000000000000000000
00000000000000000000000000000000000000000000000000000000000000000000000000000000
00000000666600000000000000006666000000000000000066660000000000000000666600000000
00000000111100000000000000001111000000000000000011110000000000000000111100000000
00000000111100000000000000001111000000000000000011110000000000000000111100000000
00000000000000000000000000000000000000000000000000000000000000000000000000000000
00000000000000000000000000000000000000000000000000000000000000000000000000000000
00000000000000000000000000000000000000000000000000000000000000000000000000000000
00000000000000000000000000000000000000000000000000000000000000000000000000000000
11111111111111111111111111111111111111111111111111111111111111111111111111111111
11111111111111111111111111111111111111111111111111111111111111111111111111111111
11111111000011111111111111110000111111111111111100001111111111111111000011111111
11111110000001111111111111100000011111111111111000000111111111111110000001111111
11111110000001111111111111100000011111111111111000000111111111111110000001111111
11111100011000111111111111000110001111111111110001100011111111111100011000111111
00010000711500001000000100007115000010000001000071150000100000010000711500001000
00000000711500000000000000007115000000000000000071150000000000000000711500000000
00000000044000000000000000000440000000000000000004400000000000000000044000000000
00000000000000000000000000000000000000000000000000000000000000000000000000000000
00000000000000000000000000000000000000000000000000000000000000000000000000000000
00000000000000000000000000000000000000000000000000000000000000000000000000000000
00000000000000000000000000000000000000000000000000000000000000000000000000000000
00000000000000000000000000000000000000000000000000000000000000000000000000000000
00000000000000000000000000000000000000000000000000000000000000000000000000000000
00000000000000000000000000000000000000000000000000000000000000000000000000000000