11100000000000000111
11100000000000000111
11100000000000000111
11100000000000000111
11111000000000000111
11111111111111111111
00000000000000000000
00000000000000000000
00000000100000000000
00000000111111110000
00001100000000000000
00000011111111110000
00001110000000000000
00000000000000000000
00000000000000000000
