11100000000000000111
11100000000000000111
11100000000000000111
11100000000000000111
11100000000000000111
11111111111111111111
00000000000000000000
00000000000000000000
00000000000000000000
00011111111111111000
11100000000000000111
00000000000000000000
00000000000000000000
00000000000000000000
00000000000000000000
