11100000000000000111
11100000000000000111
11100000000000000111
11111111111111111111
11111111111111111111
11111111111111111111
00000000000000000000
00000000000000000000
00000000000000000000
00000000000000000000
00000000000000000000
00000001000000000000
00000001000000000000
00000001000000000000
00000000000000000000
11100000000000000111
11100000000000000111
11100000000000000111
11111111111111111111
11111111111111111111
11111111111111111111
00000000000000000000
00000000000000000000
00000000000000000000
00000000000000000000
00000000000000000000
00000001000001110000
00000001000001100000
00000001000111100000
00000000000000000000
