11100000000000000111
11100000000000000111
11100000000000000111
11100000000000000111
11100000000000000111
11111111111111111111
00000000000000000000
00000000000000000000
00000000000000000000
00000000000000000000
00000000000000000000
11111111111111111111
00000000000000000000
00000000000000000000
00000000000000000000
