11111111000111111111111111110001111111111111111100011111111111111111000111111111
11111111000111111111111111110001111111111111111100011111111111111111000111111111
11111111000111111111111111110001111111111111111100011111111111111111000111111111
11111110000111111111111111100001111111111111111000011111111111111110000111111111
11111111000111111111111111110001111111111111111100011111111111111111000111111111
11111111000111111111111111110001111111111111111100011111111111111111000111111111
00000000000000000000000000000000000000000000000000000000000000000000000000000000
00000000000000000000000000000000000000000000000000000000000000000000000000000000
00000000000000000000000000000000000000000000000000000000000000000000000000000000
00000000000000000000000000000000000000000000000000000000000000000000000000000000
00000000000000000000000000000000000000000000000000000000000000000000000000000000
00000000000000000000000000000000000000000000000000000000000000000000000000000000
00000000000000000000000000000000000000000000000000000000000000000000000000000000
00000000000000000000000000000000000000000000000000000000000000000000000000000000
00000000000000000000000000000000000000000000000000000000000000000000000000000000

