11100011111110000111111000111111100001111110001111111000011111100011111110000111
11100001111110000111111000011111100001111110000111111000011111100001111110000111
11100000111110000111111000001111100001111110000011111000011111100000111110000111
11100000011110000111111000000111100001111110000001111000011111100000011110000111
11111111111111111111111111111111111111111111111111111111111111111111111111111111
11111111111111111111111111111111111111111111111111111111111111111111111111111111
00000000004400000000000000000044000000000000000000440000000000000000004400000000
00000000000000000000000000000000000000000000000000000000000000000000000000000000
00000000000000000000000000000000000000000000000000000000000000000000000000000000
00000000000000000000000000000000000000000000000000000000000000000000000000000000
01111000000000000000011110000000000000000111100000000000000001111000000000000000
00000111100000000000000001111110000000000000011111100000000000000111111000000000
00000000000000000000000000000000000000000000000000011100000000000000000111000000
00000000000000000000000000000000000000000000000000000000000000000000000000111000
00000000000000000000000000000000000000000000000000000000000000000000000000000000