11100011111110000111
11100001111110000111
11100000111110000111
11100000011110000111
11111111111111111111
11111111111111111111
00000011110011000000
00000000110001000000
00000000000001000000
00000000000001000000
01110000000001000000
00000000000001000000
00000000000001000000
00000000000000000000
00000000000000000000
