11100000000000000111
11100000000000000111
11100000000000000111
11100000000000000111
11100000000000000111
11111111111111111111
00000000000000000000
00000000000000000000
00000000000000000000
00000000000000077000
00000000000000077000
00000444444444400000
00000000000000000000
00000000000000000000
00000000000000000000
11100000000000000111
11100000000000000111
11100000000000000111
11100000000000000111
11100000000000000111
11111111111111111111
00000000000000000000
00000000000000000000
00000000000000000000
00066000000000077000
00066000000000077000
00055444444444455000
00000000000000000000
00000000000000000000
00000000000000000000
